1 1 1 1 1 1 1 0 1 1 1 1 1 1 1 1 1 1
1 1 7 1 1 1 1 0 1 1 1 1 0 0 0 7 1 1
1 1 0 1 1 1 1 0 1 1 1 1 1 0 1 1 1 1
1 1 0 1 1 1 1 0 1 1 1 1 1 0 1 1 1 1
1 1 0 1 1 3 1 0 1 1 1 1 1 0 1 1 1 1
1 1 0 1 1 1 1 0 1 1 1 1 1 1 1 1 1 1
1 1 1 1 1 1 1 0 1 1 1 1 1 1 1 1 1 1
0 0 0 0 0 0 0 2 0 3 1 1 1 1 1 1 1 1
1 1 1 1 1 1 1 1 1 1 1 1 1 1 1 1 1 1
1 1 1 1 1 1 1 1 1 1 1 1 8 1 1 1 1 1
1 1 1 0 0 0 0 0 7 1 1 1 0 1 1 1 1 1
1 1 1 1 1 0 1 1 1 1 1 1 0 1 1 1 1 1
1 1 1 1 0 3 0 7 0 1 1 1 0 1 1 1 1 1
1 1 1 1 0 1 1 1 1 1 1 1 8 1 1 1 1 1
1 1 1 1 0 1 1 1 1 1 1 1 0 1 1 1 1 1
1 1 1 1 0 1 1 1 1 1 1 1 1 1 1 1 1 1
1 1 1 1 0 1 1 1 1 1 1 1 1 1 1 1 1 1
1 1 1 1 0 1 1 1 1 1 1 1 1 1 1 1 1 1