1 1 1 1 1 1 1 1 1 1 1 1 1 0 1 1 1 1
1 1 1 1 1 1 1 1 1 1 1 1 1 0 0 7 1 1
1 1 1 0 0 0 0 7 8 0 0 0 1 1 3 0 0 1
1 1 1 1 1 1 0 0 0 1 1 1 1 1 1 1 0 0
1 1 1 1 1 1 3 3 1 1 1 1 1 1 1 1 1 1
1 1 1 1 1 3 0 0 1 3 3 1 1 1 1 1 1 1
1 1 1 1 1 3 0 0 3 1 1 3 1 1 1 1 1 1
1 1 1 1 1 3 0 2 0 0 8 1 0 8 1 1 1 1
1 1 1 1 1 3 3 3 0 3 3 1 1 1 1 1 1 1
1 1 1 1 1 1 1 1 1 1 1 1 1 1 1 1 1 1
1 1 1 1 1 1 1 1 0 0 1 1 1 1 1 1 1 1
1 1 1 1 1 1 1 1 8 1 1 1 1 1 1 1 1 1
1 1 1 1 1 1 0 0 0 0 0 1 1 1 1 1 1 1
1 1 1 1 1 8 0 1 1 1 0 1 1 1 1 1 1 1
1 1 1 1 1 1 0 0 7 0 0 0 0 1 1 1 1 1
1 1 1 1 1 1 1 1 1 1 1 1 1 1 1 1 1 1
1 1 1 1 1 1 1 1 1 1 1 1 1 1 1 1 1 1
1 1 1 1 1 1 1 1 1 1 1 1 1 1 1 1 1 1