1 1 1 1 0 3 1 0 1 1 1 1 1 1 1 1 1 1
1 1 1 1 0 3 1 0 1 1 0 7 0 0 1 1 1 1
1 1 1 1 0 3 1 0 1 1 1 1 1 0 0 0 0 0
1 1 1 0 0 3 1 0 1 1 1 1 1 1 3 3 1 1
1 1 0 0 3 1 1 0 1 1 1 1 1 1 1 1 1 1
1 0 0 3 1 1 1 0 1 1 1 1 1 1 1 1 1 1
1 7 3 1 1 1 1 0 1 1 1 1 1 1 1 1 1 1
1 1 1 1 1 1 0 2 0 1 1 1 1 1 1 1 1 1
1 1 1 1 1 1 1 3 1 1 1 1 1 1 1 1 1 1
1 1 1 1 1 1 1 1 1 1 1 1 1 0 1 1 1 1
1 1 1 0 0 0 0 0 0 1 1 1 1 0 1 1 1 1
1 1 1 0 1 8 1 1 0 1 1 1 1 7 1 1 1 1
1 1 1 0 1 1 1 1 0 1 1 1 1 0 1 1 1 1
1 1 1 0 0 0 0 8 0 1 1 1 1 0 1 1 1 1
1 1 1 1 1 1 1 1 1 1 1 1 1 1 1 1 1 1
1 1 1 1 1 1 1 1 1 1 1 1 1 1 1 1 1 1
1 1 1 1 1 1 1 1 1 1 1 1 1 1 1 1 1 1
1 1 1 1 1 1 1 1 1 1 1 1 1 1 1 1 1 1